1-11-110-111-2
1-11-110-112-2
1-12-120-121-2
1-12-120-122-2
1-13-130-131-2
1-13-130-132-2
